<Tiles>
<Ground>
<Tile>
Resources/Tiles/Ground/pool6.png
</Tile>
<Tile>
Resources/Tiles/Ground/cliff_corner_DL_inv.png
</Tile>
<Tile>
Resources/Tiles/Ground/pool8.png
</Tile>
<Tile>
Resources/Tiles/Ground/wall.png
</Tile>
<Tile>
Resources/Tiles/Ground/pool1.png
</Tile>
<Tile>
Resources/Tiles/Ground/wallleft.png
</Tile>
<Tile>
Resources/Tiles/Ground/cliff_corner_DR_inv.png
</Tile>
<Tile>
Resources/Tiles/Ground/walldown.png
</Tile>
<Tile>
Resources/Tiles/Ground/cliff1.png
</Tile>
<Tile>
Resources/Tiles/Ground/zwallcorner0.png
</Tile>
<Tile>
Resources/Tiles/Ground/pool9.png
</Tile>
<Tile>
Resources/Tiles/Ground/wallup.png
</Tile>
<Tile>
Resources/Tiles/Ground/zwallcorner1.png
</Tile>
<Tile>
Resources/Tiles/Ground/wallright.png
</Tile>
<Tile>
Resources/Tiles/Ground/dungeon.png
</Tile>
<Tile>
Resources/Tiles/Ground/cliff_corner_UL.png
</Tile>
<Tile>
Resources/Tiles/Ground/water.png
</Tile>
<Tile>
Resources/Tiles/Ground/cliff2.png
</Tile>
<Tile>
Resources/Tiles/Ground/blank.png
</Tile>
<Tile>
Resources/Tiles/Ground/pool4.png
</Tile>
<Tile>
Resources/Tiles/Ground/dirt.png
</Tile>
<Tile>
Resources/Tiles/Ground/zwallcorner2.png
</Tile>
<Tile>
Resources/Tiles/Ground/cliff.png
</Tile>
<Tile>
Resources/Tiles/Ground/cliff_corner_UR_inv.png
</Tile>
<Tile>
Resources/Tiles/Ground/cliff_corner_DR.png
</Tile>
<Tile>
Resources/Tiles/Ground/pool5.png
</Tile>
<Tile>
Resources/Tiles/Ground/cliff_corner_UR.png
</Tile>
<Tile>
Resources/Tiles/Ground/pool3.png
</Tile>
<Tile>
Resources/Tiles/Ground/pool2.png
</Tile>
<Tile>
Resources/Tiles/Ground/cliff_corner_DL.png
</Tile>
<Tile>
Resources/Tiles/Ground/zwallcorner3.png
</Tile>
<Tile>
Resources/Tiles/Ground/pool7.png
</Tile>
<Tile>
Resources/Tiles/Ground/cliff_corner_UL_inv.png
</Tile>
</Ground>
<Object>
<Tile>
Resources/Tiles/Objects/hay_top.png
</Tile>
<Tile>
Resources/Tiles/Objects/bars_top.png
</Tile>
<Tile>
Resources/Tiles/Objects/bars_bot.png
</Tile>
<Tile>
Resources/Tiles/Objects/chair0.png
</Tile>
<Tile>
Resources/Tiles/Objects/well2.png
</Tile>
<Tile>
Resources/Tiles/Objects/logs.png
</Tile>
<Tile>
Resources/Tiles/Objects/flower0.png
</Tile>
<Tile>
Resources/Tiles/Objects/table.png
</Tile>
<Tile>
Resources/Tiles/Objects/wiz_statue1.png
</Tile>
<Tile>
Resources/Tiles/Objects/gate1ur.png
</Tile>
<Tile>
Resources/Tiles/Objects/pot.png
</Tile>
<Tile>
Resources/Tiles/Objects/flower1.png
</Tile>
<Tile>
Resources/Tiles/Objects/gate1bl.png
</Tile>
<Tile>
Resources/Tiles/Objects/cage_left_top.png
</Tile>
<Tile>
Resources/Tiles/Objects/gate1br.png
</Tile>
<Tile>
Resources/Tiles/Objects/door_bot.png
</Tile>
<Tile>
Resources/Tiles/Objects/cage_left_bot.png
</Tile>
<Tile>
Resources/Tiles/Objects/door1.png
</Tile>
<Tile>
Resources/Tiles/Objects/monk_statue1.png
</Tile>
<Tile>
Resources/Tiles/Objects/blank.png
</Tile>
<Tile>
Resources/Tiles/Objects/wiz_statue2.png
</Tile>
<Tile>
Resources/Tiles/Objects/well3.png
</Tile>
<Tile>
Resources/Tiles/Objects/fire.png
</Tile>
<Tile>
Resources/Tiles/Objects/hay_bot.png
</Tile>
<Tile>
Resources/Tiles/Objects/monk_statue2.png
</Tile>
<Tile>
Resources/Tiles/Objects/torch_top.png
</Tile>
<Tile>
Resources/Tiles/Objects/well1.png
</Tile>
<Tile>
Resources/Tiles/Objects/cage_left_mid.png
</Tile>
<Tile>
Resources/Tiles/Objects/well0.png
</Tile>
<Tile>
Resources/Tiles/Objects/door1open.png
</Tile>
<Tile>
Resources/Tiles/Objects/torch_bot.png
</Tile>
<Tile>
Resources/Tiles/Objects/door.png
</Tile>
<Tile>
Resources/Tiles/Objects/chair1.png
</Tile>
<Tile>
Resources/Tiles/Objects/gate1ul.png
</Tile>
</Object>
</Tiles>
<MAP>
<Size>
44,44
</Size>
<GroundMap>
20 20 20 20 20 20 20 20 20 20 20 20 20 20 20 20 20 20 20 20 20 20 20 20 20 20 20 20 20 20 20 20 20 20 20 20 20 20 20 20 20 20 20 20 
20 20 20 20 20 20 20 20 20 20 20 20 20 20 20 20 20 20 20 20 20 20 20 20 20 20 20 20 20 20 20 20 20 20 20 20 20 20 20 20 20 20 20 20 
20 20 20 20 20 20 20 20 20 20 20 20 20 20 20 20 20 20 20 20 20 20 20 20 20 20 20 20 20 20 20 20 20 20 20 20 20 20 20 20 20 20 20 20 
20 20 21 7 7 7 7 7 20 20 7 7 7 7 7 7 7 7 7 7 7 7 7 7 7 7 7 7 7 7 7 7 7 7 7 7 7 7 7 7 7 12 20 20 
20 20 5 14 14 14 14 14 14 14 14 14 14 14 14 14 14 14 14 14 14 13 5 14 14 14 14 14 14 14 14 14 14 13 14 14 14 14 14 14 14 13 20 20 
20 20 5 14 14 14 14 14 14 14 14 14 14 14 14 14 14 14 14 14 14 13 5 14 14 14 14 14 14 14 14 14 14 13 14 14 14 14 14 14 14 13 20 20 
20 20 5 14 14 14 14 14 14 14 14 14 14 14 14 14 14 14 14 14 14 13 5 14 14 14 14 14 14 14 14 14 14 13 14 14 14 14 14 14 14 13 20 20 
20 20 5 14 14 14 14 14 14 14 14 14 14 14 14 14 14 14 14 14 14 13 5 14 14 14 14 14 14 14 14 14 14 14 14 14 14 14 14 14 14 13 20 20 
20 20 5 14 14 14 14 14 14 14 14 14 14 14 14 14 14 14 14 14 14 13 5 14 14 14 14 14 14 14 14 14 14 13 14 14 14 14 14 14 14 13 20 20 
20 20 5 14 14 14 14 14 14 14 14 14 14 14 14 14 14 14 14 14 14 13 5 14 14 14 14 14 14 14 14 14 14 13 14 14 14 14 14 14 14 13 20 20 
20 20 5 14 14 14 14 14 14 14 14 14 14 14 14 14 14 14 14 14 14 13 5 14 14 14 14 14 14 14 14 14 14 13 14 14 14 14 14 14 14 13 20 20 
20 20 21 7 7 7 7 7 7 7 7 7 7 14 7 7 7 7 7 7 7 12 21 7 7 7 7 7 14 7 7 7 7 12 7 7 7 7 14 7 7 12 20 20 
20 20 30 14 14 14 14 14 14 14 14 14 14 14 14 14 14 14 14 14 14 13 5 14 14 14 14 14 14 14 14 14 14 14 14 14 14 14 14 14 14 13 20 20 
20 20 5 14 14 14 14 14 14 14 14 14 14 14 14 14 14 14 14 14 14 13 5 14 14 14 14 14 14 14 14 14 14 14 14 14 14 14 14 14 14 13 20 20 
20 20 5 14 14 14 14 14 14 14 14 14 14 14 14 14 14 14 14 14 14 13 5 14 14 14 14 14 14 14 14 14 14 14 14 14 14 14 14 14 14 13 20 20 
20 20 5 14 14 14 14 14 14 14 14 14 14 14 14 14 14 14 14 14 14 13 5 14 14 14 14 14 14 14 14 14 14 14 14 14 14 14 14 14 14 13 20 20 
20 20 5 14 14 14 14 14 14 14 14 14 14 14 14 14 14 14 14 14 14 13 5 14 14 14 14 14 14 14 27 0 0 10 14 14 14 14 14 14 14 13 20 20 
20 20 5 14 14 14 14 14 14 14 14 14 14 14 14 14 14 14 14 14 14 13 5 14 14 14 14 14 14 14 28 25 25 2 14 14 14 14 14 14 14 13 20 20 
20 20 5 14 14 14 14 14 14 14 14 14 14 14 14 14 14 14 14 14 14 13 5 14 14 14 14 14 14 14 4 19 19 31 14 14 14 14 14 14 14 13 20 20 
20 20 5 14 14 14 14 14 14 14 14 14 14 14 14 14 14 14 14 14 14 13 5 14 14 14 14 14 14 14 14 14 14 14 14 14 14 14 14 14 14 13 20 20 
20 20 5 14 14 14 14 14 14 14 14 14 14 14 14 14 14 14 14 14 14 13 5 14 14 14 14 14 14 14 14 14 14 14 14 14 14 14 14 14 14 13 20 20 
20 20 5 14 14 14 14 14 14 14 14 14 14 14 14 14 14 14 14 14 14 13 5 14 14 14 14 14 14 14 14 14 14 14 14 14 14 14 14 14 14 13 20 20 
20 20 5 14 14 14 14 14 14 14 14 14 14 14 14 14 14 14 14 14 14 13 5 14 14 14 14 14 14 14 14 14 14 14 14 14 14 14 14 14 14 13 20 20 
20 20 5 14 14 14 14 14 14 14 14 14 14 14 14 14 14 14 14 14 14 13 5 14 14 14 14 14 14 14 14 14 14 14 14 14 14 14 14 14 14 13 20 20 
20 20 5 14 14 14 14 14 14 14 14 14 14 14 14 14 14 14 14 14 14 13 5 14 14 14 14 14 14 14 14 14 14 14 14 14 14 14 14 14 14 13 20 20 
20 20 21 7 7 7 7 7 7 7 7 7 7 14 7 7 7 7 7 7 7 12 21 7 7 7 7 7 7 7 7 7 14 7 7 7 7 7 7 7 7 12 20 20 
20 20 5 14 14 14 14 14 14 14 14 14 14 14 14 14 14 14 14 14 14 14 14 14 14 14 14 14 14 14 14 14 14 14 14 14 14 14 14 14 14 13 20 20 
20 20 5 14 14 14 14 14 14 14 14 14 14 14 14 14 14 14 14 14 14 14 14 14 14 14 14 14 14 14 14 14 14 14 14 14 14 14 14 14 14 13 20 20 
20 20 5 14 14 14 14 14 14 14 14 14 14 14 14 14 14 14 14 14 14 14 14 14 14 14 14 14 14 14 14 14 14 14 14 14 14 14 14 14 14 13 20 20 
20 20 5 14 14 14 14 14 14 14 14 14 14 14 14 14 14 14 14 14 14 14 14 14 14 14 14 14 14 14 14 14 14 14 14 14 14 14 14 14 14 13 20 20 
20 20 5 14 14 14 14 14 14 14 14 14 14 14 14 14 14 14 14 14 14 14 14 14 14 14 14 14 14 14 14 14 14 14 14 14 14 14 14 14 14 13 20 20 
20 20 5 14 14 14 14 14 14 14 14 14 14 14 14 14 14 14 14 14 14 14 14 14 14 14 14 14 14 14 14 14 14 14 14 14 14 14 14 14 14 13 20 20 
20 20 5 14 14 14 14 14 14 14 14 14 14 14 14 14 14 14 14 14 14 14 14 14 14 14 14 14 14 14 14 30 11 11 11 11 11 11 11 11 11 9 20 20 
20 20 5 14 14 14 14 14 14 14 14 14 14 14 14 14 14 14 14 14 14 14 14 14 14 14 14 14 14 14 14 5 14 14 14 14 14 14 14 14 14 13 20 20 
20 20 5 14 14 14 14 14 14 14 14 14 14 14 14 14 14 14 14 14 14 14 14 14 14 14 14 14 14 14 14 5 14 14 14 14 14 14 14 14 14 13 20 20 
20 20 5 14 14 14 14 14 14 14 14 14 14 14 14 14 14 14 14 14 14 14 14 14 14 14 14 14 14 14 14 5 14 14 14 14 14 14 14 14 14 13 20 20 
20 20 5 14 14 14 14 14 14 14 14 14 14 14 14 14 14 14 14 14 14 14 14 14 14 14 14 14 14 14 14 5 14 14 14 14 14 14 14 14 14 13 20 20 
20 20 5 14 14 14 14 14 14 14 14 14 14 14 14 14 14 14 14 14 14 14 14 14 14 14 14 14 14 14 14 5 14 14 14 14 14 14 14 14 14 14 20 20 
20 20 5 14 14 14 14 14 14 14 14 14 14 14 14 14 14 14 14 14 14 14 14 14 14 14 14 14 14 14 14 14 14 14 14 14 14 14 14 14 14 13 20 20 
20 20 5 14 14 14 14 14 14 14 14 14 14 14 14 14 14 14 14 14 14 14 14 14 14 14 14 14 14 14 14 5 14 14 14 14 14 14 14 14 14 13 20 20 
20 20 5 14 14 14 14 14 14 14 14 14 14 14 14 14 14 14 14 14 14 14 14 14 14 14 14 14 14 14 14 5 14 14 14 14 14 14 14 14 14 13 20 20 
20 20 21 7 7 7 7 7 7 7 7 7 7 7 7 7 7 7 7 7 7 7 7 7 7 7 7 7 7 7 7 21 7 7 7 7 7 7 7 7 7 12 20 20 
20 20 20 20 20 20 20 20 20 20 20 20 20 20 20 20 20 20 20 20 20 20 20 20 20 20 20 20 20 20 20 20 20 20 20 20 20 20 20 20 20 20 20 20 
20 20 20 20 20 20 20 20 20 20 20 20 20 20 20 20 20 20 20 20 20 20 20 20 20 20 20 20 20 20 20 20 20 20 20 20 20 20 20 20 20 20 20 20 
</GroundMap>
<ObjectMap>
19 19 19 19 19 19 19 19 19 19 19 19 19 19 19 19 19 19 19 19 19 19 19 19 19 19 19 19 19 19 19 19 19 19 19 19 19 19 19 19 19 19 19 19 
19 19 19 19 19 19 19 19 19 19 19 19 19 19 19 19 19 19 19 19 11 19 6 19 19 19 11 19 19 6 19 19 19 19 19 19 19 19 19 19 19 19 19 19 
19 19 19 19 19 19 19 19 19 19 19 19 19 19 19 19 19 19 19 19 19 19 19 19 19 19 19 19 19 19 19 19 19 19 19 19 19 19 19 19 19 19 19 19 
19 19 19 19 19 19 19 19 19 19 19 19 19 19 19 19 19 19 19 19 19 19 19 19 19 19 19 19 19 19 19 19 19 19 19 19 19 19 19 19 19 19 19 19 
19 19 19 25 19 19 19 19 19 19 19 19 19 19 19 19 19 19 19 19 19 25 25 19 19 19 19 19 19 19 19 19 25 19 25 19 13 19 19 19 19 19 19 19 
19 19 19 19 19 19 19 19 19 19 19 19 19 19 19 19 19 19 19 19 19 30 30 19 19 19 19 19 19 19 19 19 30 19 30 19 13 19 19 19 19 19 19 19 
19 19 19 19 19 19 19 19 19 19 19 19 19 19 19 19 19 19 19 19 19 19 19 19 19 19 19 19 19 19 19 19 19 19 19 19 27 1 31 1 1 19 19 19 
19 19 19 19 19 19 19 19 19 19 19 19 19 19 19 19 19 19 19 19 19 19 19 19 19 19 19 19 19 19 19 19 19 19 19 19 16 2 19 2 2 19 19 19 
19 19 19 19 19 19 19 19 19 19 19 19 19 19 19 19 19 19 19 19 19 19 19 19 19 19 19 19 19 19 19 19 19 19 19 19 19 19 19 19 19 19 19 19 
19 19 19 19 19 19 19 19 19 19 19 19 19 19 19 19 19 19 19 19 19 19 19 0 0 19 19 19 19 19 19 19 19 19 19 19 19 19 19 19 19 19 19 19 
19 19 19 19 19 19 19 19 19 19 19 19 19 19 19 19 19 19 19 19 19 19 19 23 23 19 19 19 19 19 19 19 19 19 19 19 19 19 19 19 19 19 19 19 
19 19 19 19 19 19 19 19 19 19 19 19 19 19 19 19 19 19 19 19 19 19 19 19 19 19 19 19 19 19 19 19 19 19 19 19 19 19 19 19 19 19 19 19 
19 19 19 19 19 19 19 19 19 19 19 19 19 19 19 19 19 19 19 19 19 25 25 19 19 19 19 19 19 19 19 8 8 19 19 19 19 19 19 19 25 19 19 19 
19 19 19 19 19 19 19 19 19 19 19 19 19 19 19 19 19 19 19 19 19 30 30 19 19 19 19 19 19 19 19 20 20 19 19 19 19 19 19 19 30 19 19 19 
19 19 19 19 19 19 19 19 19 19 19 19 19 19 19 19 19 19 19 19 19 19 19 19 19 19 18 19 19 19 19 19 19 19 19 19 19 18 19 19 19 19 19 19 
19 19 19 19 19 19 19 19 19 19 19 19 19 19 19 19 19 19 19 19 19 19 19 19 19 19 24 19 19 19 25 19 19 25 19 19 19 24 19 19 19 19 19 19 
19 19 19 19 19 19 19 19 19 19 19 19 19 19 19 19 19 19 19 19 19 19 19 19 19 19 19 19 19 19 19 19 19 19 19 19 19 19 19 19 19 19 19 19 
19 19 19 19 19 19 19 19 19 19 19 19 19 19 19 19 19 19 19 19 19 19 19 19 19 19 19 19 19 19 19 19 19 19 19 19 19 19 19 19 19 19 19 19 
19 19 19 19 19 3 7 32 19 19 19 19 19 19 3 7 32 19 19 19 19 19 19 19 19 19 19 19 19 19 19 19 19 19 19 19 19 19 19 19 19 19 19 19 
19 19 19 19 19 19 19 19 19 19 19 19 19 19 19 19 19 19 19 19 19 19 19 19 19 19 19 19 19 19 19 19 19 19 19 19 19 19 19 19 19 19 19 19 
19 19 19 19 19 19 19 19 19 19 19 19 19 19 19 19 19 19 19 19 19 19 19 19 19 19 18 19 19 19 19 19 19 19 19 19 19 18 19 19 19 19 19 19 
19 19 19 19 19 19 19 19 19 19 19 19 19 19 19 19 19 19 19 19 19 19 19 19 19 19 24 19 19 19 19 19 19 19 19 19 19 24 19 19 19 19 19 19 
11 19 19 19 19 19 19 19 19 19 19 19 19 19 19 19 19 19 19 19 19 25 25 19 19 19 19 19 19 19 19 19 19 19 19 19 19 19 19 19 19 19 19 19 
19 19 19 19 19 19 19 19 19 19 19 19 19 19 19 19 19 19 19 19 19 30 30 19 19 19 19 19 19 19 19 19 19 19 19 19 19 19 19 19 19 19 19 19 
11 19 19 19 19 19 19 19 19 19 19 19 19 19 19 19 19 19 19 19 19 19 19 19 19 19 19 19 19 19 19 19 19 19 19 19 19 19 19 19 19 19 19 19 
19 19 19 19 19 19 19 19 19 19 19 19 19 19 19 19 19 19 19 19 19 19 19 19 19 19 19 19 19 19 19 19 19 19 19 19 19 19 19 19 19 19 19 19 
19 19 19 19 19 19 19 19 19 19 19 19 19 19 19 19 19 19 19 19 19 19 19 19 19 19 19 19 19 19 19 19 19 19 19 19 19 19 19 19 19 19 19 19 
19 19 19 19 19 19 19 19 19 19 19 19 19 19 19 19 19 19 19 19 19 19 19 19 19 19 19 19 19 19 19 19 19 19 19 19 19 19 19 19 19 19 19 19 
19 19 19 19 19 19 19 19 19 19 19 19 19 19 19 19 19 19 19 19 19 19 19 19 19 19 19 19 19 19 19 19 19 19 19 19 19 19 19 19 19 19 19 19 
19 19 19 19 19 19 19 19 19 19 19 19 19 19 19 19 19 19 19 19 19 19 19 19 19 19 19 19 19 19 19 19 19 19 19 19 19 19 19 19 19 19 19 19 
19 19 19 19 19 19 19 19 19 19 19 19 19 19 19 19 19 19 19 19 19 19 19 19 19 19 19 19 19 19 19 19 19 19 19 19 19 19 19 19 19 19 19 19 
19 19 19 19 19 19 19 19 19 19 28 26 19 19 19 19 19 19 19 19 19 19 19 19 19 19 19 19 19 19 19 19 19 19 19 19 19 19 19 19 19 19 19 19 
19 19 19 19 19 19 19 19 19 19 4 21 19 19 19 19 19 19 19 19 19 19 19 19 19 19 19 19 19 19 19 19 19 19 19 19 19 19 19 19 19 19 19 19 
19 19 19 19 19 19 19 19 19 19 19 19 19 19 19 19 19 19 19 19 19 19 19 19 19 19 19 19 19 19 19 19 19 19 19 19 19 19 19 19 19 19 19 19 
19 19 19 19 19 19 19 19 19 19 19 19 19 19 19 19 19 19 19 19 19 19 19 19 19 19 19 19 19 19 19 19 19 19 19 19 19 19 19 19 19 19 19 19 
19 19 19 19 19 19 19 19 19 19 19 19 19 19 19 19 19 19 19 19 19 19 19 19 19 19 19 19 19 19 19 19 19 19 19 19 19 19 19 19 19 19 19 19 
19 19 19 5 19 19 19 19 19 19 19 19 19 19 19 19 19 19 19 19 19 19 19 19 19 19 19 19 19 19 19 19 19 19 19 19 19 19 19 19 19 19 19 19 
19 19 19 5 19 10 19 19 19 19 19 19 19 19 19 19 19 19 19 19 22 19 19 19 19 19 19 19 19 19 19 19 19 19 19 19 19 19 19 19 19 19 19 19 
19 19 19 5 19 19 19 19 19 19 19 19 19 19 19 19 19 19 19 19 19 19 19 19 19 19 19 19 19 19 19 19 19 19 19 19 19 19 19 19 19 19 19 19 
19 19 19 19 19 19 19 19 0 19 0 19 0 19 0 19 0 19 19 19 19 19 19 19 19 19 19 19 19 19 19 19 19 19 19 19 19 19 19 19 19 19 19 19 
19 19 19 19 19 19 19 19 23 19 23 19 23 19 23 19 23 19 19 19 5 5 19 19 19 19 19 19 19 19 19 19 19 19 19 19 19 19 19 19 19 19 19 19 
19 19 19 19 19 19 19 19 19 19 19 19 19 19 19 19 19 19 19 19 19 19 19 19 19 19 19 19 19 19 19 19 19 19 19 19 19 19 19 19 19 19 19 19 
19 19 19 19 19 19 19 19 19 19 19 19 19 19 19 19 19 19 19 19 19 19 19 19 19 19 19 19 19 19 19 19 19 19 19 19 19 19 19 19 19 19 19 19 
19 19 19 19 19 19 19 19 19 19 19 19 19 19 19 19 19 19 19 19 19 19 19 19 19 19 19 19 19 6 6 19 19 19 19 19 19 19 19 19 19 19 19 19 
</ObjectMap>
<ColisionMap>
0 0 0 0 0 0 0 0 0 0 0 0 0 0 0 0 0 0 0 0 0 0 0 0 0 0 0 0 0 0 0 0 0 0 0 0 0 0 0 0 0 0 0 0 
0 0 0 0 0 0 0 0 0 0 0 0 0 0 0 0 0 0 0 0 0 0 0 0 0 0 0 0 0 0 0 0 0 0 0 0 0 0 0 0 0 0 0 0 
0 0 0 0 0 0 0 0 0 0 0 0 0 0 0 0 0 0 0 0 0 0 0 0 0 0 0 0 0 0 0 0 0 0 0 0 0 0 0 0 0 0 0 0 
0 0 1 1 1 1 1 1 0 0 1 1 1 1 1 1 1 1 1 1 1 1 1 1 1 1 1 1 1 1 1 1 1 1 1 1 1 1 1 1 1 1 0 0 
0 0 1 0 0 0 0 0 0 0 0 0 0 0 0 0 0 0 0 0 0 1 1 0 0 0 0 0 0 0 0 0 0 1 0 0 0 0 0 0 0 1 0 0 
0 0 1 0 0 0 0 0 0 0 0 0 0 0 0 0 0 0 0 0 0 1 1 0 0 0 0 0 0 0 0 0 0 1 0 0 0 0 0 0 0 1 0 0 
0 0 1 0 0 0 0 0 0 0 0 0 0 0 0 0 0 0 0 0 0 1 1 0 0 0 0 0 0 0 0 0 0 1 0 0 0 2 0 2 2 1 0 0 
0 0 1 0 0 0 0 0 0 0 0 0 0 0 0 0 0 0 0 0 0 1 1 0 0 0 0 0 0 0 0 0 0 0 0 0 0 2 0 2 2 1 0 0 
0 0 1 0 0 0 0 0 0 0 0 0 0 0 0 0 0 0 0 0 0 1 1 0 0 0 0 0 0 0 0 0 0 1 0 0 0 0 0 0 0 1 0 0 
0 0 1 0 0 0 0 0 0 0 0 0 0 0 0 0 0 0 0 0 0 1 1 2 2 0 0 0 0 0 0 0 0 1 0 0 0 0 0 0 0 1 0 0 
0 0 1 0 0 0 0 0 0 0 0 0 0 0 0 0 0 0 0 0 0 1 1 2 2 0 0 0 0 0 0 0 0 1 0 0 0 0 0 0 0 1 0 0 
0 0 1 1 1 1 1 1 1 1 1 1 1 0 1 1 1 1 1 1 1 1 1 1 1 1 1 1 0 1 1 1 1 1 1 1 1 1 0 1 1 1 0 0 
0 0 1 0 0 0 0 0 0 0 0 0 0 0 0 0 0 0 0 0 0 1 1 0 0 0 0 0 0 0 0 2 2 0 0 0 0 0 0 0 0 1 0 0 
0 0 1 0 0 0 0 0 0 0 0 0 0 0 0 0 0 0 0 0 0 1 1 0 0 0 0 0 0 0 0 2 2 0 0 0 0 0 0 0 0 1 0 0 
0 0 1 0 0 0 0 0 0 0 0 0 0 0 0 0 0 0 0 0 0 1 1 0 0 0 2 0 0 0 0 0 0 0 0 0 0 2 0 0 0 1 0 0 
0 0 1 0 0 0 0 0 0 0 0 0 0 0 0 0 0 0 0 0 0 1 1 0 0 0 2 0 0 0 2 0 0 2 0 0 0 2 0 0 0 1 0 0 
0 0 1 0 0 0 0 0 0 0 0 0 0 0 0 0 0 0 0 0 0 1 1 0 0 0 0 0 0 0 2 2 2 2 0 0 0 0 0 0 0 1 0 0 
0 0 1 0 0 0 0 0 0 0 0 0 0 0 0 0 0 0 0 0 0 1 1 0 0 0 0 0 0 0 2 2 2 2 0 0 0 0 0 0 0 1 0 0 
0 0 1 0 0 2 2 2 0 0 0 0 0 0 2 2 2 0 0 0 0 1 1 0 0 0 0 0 0 0 2 2 2 2 0 0 0 0 0 0 0 1 0 0 
0 0 1 0 0 0 0 0 0 0 0 0 0 0 0 0 0 0 0 0 0 1 1 0 0 0 0 0 0 0 0 0 0 0 0 0 0 0 0 0 0 1 0 0 
0 0 1 0 0 0 0 0 0 0 0 0 0 0 0 0 0 0 0 0 0 1 1 0 0 0 2 0 0 0 0 0 0 0 0 0 0 2 0 0 0 1 0 0 
0 0 1 0 0 0 0 0 0 0 0 0 0 0 0 0 0 0 0 0 0 1 1 0 0 0 2 0 0 0 0 0 0 0 0 0 0 2 0 0 0 1 0 0 
0 0 1 0 0 0 0 0 0 0 0 0 0 0 0 0 0 0 0 0 0 1 1 0 0 0 0 0 0 0 0 0 0 0 0 0 0 0 0 0 0 1 0 0 
0 0 1 0 0 0 0 0 0 0 0 0 0 0 0 0 0 0 0 0 0 1 1 0 0 0 0 0 0 0 0 0 0 0 0 0 0 0 0 0 0 1 0 0 
0 0 1 0 0 0 0 0 0 0 0 0 0 0 0 0 0 0 0 0 0 1 1 0 0 0 0 0 0 0 0 0 0 0 0 0 0 0 0 0 0 1 0 0 
0 0 1 1 1 1 1 1 1 1 1 1 1 0 1 1 1 1 1 1 1 1 1 1 1 1 1 1 1 1 1 1 0 1 1 1 1 1 1 1 1 1 0 0 
0 0 1 0 0 0 0 0 0 0 0 0 0 0 0 0 0 0 0 0 0 0 0 0 0 0 0 0 0 0 0 0 0 0 0 0 0 0 0 0 0 1 0 0 
0 0 1 0 0 0 0 0 0 0 0 0 0 0 0 0 0 0 0 0 0 0 0 0 0 0 0 0 0 0 0 0 0 0 0 0 0 0 0 0 0 1 0 0 
0 0 1 0 0 0 0 0 0 0 0 0 0 0 0 0 0 0 0 0 0 0 0 0 0 0 0 0 0 0 0 0 0 0 0 0 0 0 0 0 0 1 0 0 
0 0 1 0 0 0 0 0 0 0 0 0 0 0 0 0 0 0 0 0 0 0 0 0 0 0 0 0 0 0 0 0 0 0 0 0 0 0 0 0 0 1 0 0 
0 0 1 0 0 0 0 0 0 0 0 0 0 0 0 0 0 0 0 0 0 0 0 0 0 0 0 0 0 0 0 0 0 0 0 0 0 0 0 0 0 1 0 0 
0 0 1 0 0 0 0 0 0 0 2 2 0 0 0 0 0 0 0 0 0 0 0 0 0 0 0 0 0 0 0 0 0 0 0 0 0 0 0 0 0 1 0 0 
0 0 1 0 0 0 0 0 0 0 2 2 0 0 0 0 0 0 0 0 0 0 0 0 0 0 0 0 0 0 0 1 1 1 1 1 1 1 1 1 1 1 0 0 
0 0 1 0 0 0 0 0 0 0 0 0 0 0 0 0 0 0 0 0 0 0 0 0 0 0 0 0 0 0 0 1 0 0 0 0 0 0 0 0 0 1 0 0 
0 0 1 0 0 0 0 0 0 0 0 0 0 0 0 0 0 0 0 0 0 0 0 0 0 0 0 0 0 0 0 1 0 0 0 0 0 0 0 0 0 1 0 0 
0 0 1 0 0 0 0 0 0 0 0 0 0 0 0 0 0 0 0 0 0 0 0 0 0 0 0 0 0 0 0 1 0 0 0 0 0 0 0 0 0 1 0 0 
0 0 1 2 0 0 0 0 0 0 0 0 0 0 0 0 0 0 0 0 0 0 0 0 0 0 0 0 0 0 0 1 0 0 0 0 0 0 0 0 0 1 1 0 
0 0 1 2 0 2 0 0 0 0 0 0 0 0 0 0 0 0 0 0 2 0 0 0 0 0 0 0 0 0 0 1 0 0 0 0 0 0 0 0 0 0 0 0 
0 0 1 2 0 0 0 0 0 0 0 0 0 0 0 0 0 0 0 0 0 0 0 0 0 0 0 0 0 0 0 0 0 0 0 0 0 0 0 0 0 1 1 0 
0 0 1 0 0 0 0 0 2 0 2 0 2 0 2 0 2 0 0 0 0 0 0 0 0 0 0 0 0 0 0 1 0 0 0 0 0 0 0 0 0 1 0 0 
0 0 1 0 0 0 0 0 2 0 2 0 2 0 2 0 2 0 0 0 2 2 0 0 0 0 0 0 0 0 0 1 0 0 0 0 0 0 0 0 0 1 0 0 
0 0 1 1 1 1 1 1 1 1 1 1 1 1 1 1 1 1 1 1 1 1 1 1 1 1 1 1 1 1 1 1 1 1 1 1 1 1 1 1 1 1 0 0 
0 0 0 0 0 0 0 0 0 0 0 0 0 0 0 0 0 0 0 0 0 0 0 0 0 0 0 0 0 0 0 0 0 0 0 0 0 0 0 0 0 0 0 0 
0 0 0 0 0 0 0 0 0 0 0 0 0 0 0 0 0 0 0 0 0 0 0 0 0 0 0 0 0 0 0 0 0 0 0 0 0 0 0 0 0 0 0 0 
</ColisionMap>
<Triggers>
</Triggers>
</MAP>
